20 50
1 2
10 10 10 10 10 10 10 10 10 10 10 10 10 10 10 10 10 10 10 10
10 00 00 00 00 00 00 00 00 00 00 00 00 00 00 00 00 00 00 10
10 00 00 00 00 00 00 00 00 00 00 00 00 00 00 00 00 00 00 10
10 10 00 00 00 00 00 00 00 00 00 00 00 00 00 00 00 00 00 10
10 00 00 00 00 00 00 00 00 00 00 00 00 00 00 00 00 00 00 10
10 00 00 00 00 00 00 00 00 00 00 00 00 00 00 00 00 00 00 10
10 00 00 00 00 00 00 00 00 00 00 00 00 00 00 00 00 00 00 10
10 00 00 00 00 00 80 00 00 00 00 00 00 00 00 00 00 00 00 10
10 00 00 00 00 00 10 00 00 00 00 00 00 00 00 00 00 00 00 10
10 00 00 00 00 80 00 00 80 00 00 00 00 00 00 00 00 00 00 10
10 40 40 40 40 10 00 00 10 40 40 40 40 40 40 40 40 40 40 10
10 10 10 10 10 10 00 00 10 10 10 10 10 10 10 10 10 10 10 10
10 00 00 00 00 00 00 00 00 80 00 00 00 00 00 00 00 00 00 10
10 00 00 00 00 00 00 00 00 10 40 40 40 40 40 40 40 40 40 10
10 00 00 00 80 80 80 80 00 10 08 08 08 08 08 08 08 08 08 10
10 40 40 40 10 10 10 10 00 10 10 10 10 10 10 10 10 10 10 10
10 08 08 08 10 81 81 00 00 00 00 00 00 00 00 00 00 00 00 10
10 10 10 10 10 00 00 00 00 00 00 00 00 80 00 00 00 00 00 10
10 81 81 81 00 00 10 40 40 40 40 40 40 10 00 00 00 00 00 10
10 00 00 80 00 00 10 08 08 08 08 08 08 10 00 00 00 00 00 10
10 00 00 10 00 00 10 10 10 10 10 10 10 10 00 00 00 00 00 10
10 00 00 00 00 80 00 00 00 00 00 00 00 00 00 00 00 00 00 10
10 00 00 00 00 10 00 00 00 00 00 00 00 00 00 00 00 00 00 10
10 00 00 80 00 00 00 00 00 00 00 00 00 00 00 00 00 00 00 10
10 00 00 10 00 00 00 00 00 00 00 00 00 00 00 00 00 00 00 10
10 00 00 00 00 00 00 00 00 00 00 00 00 00 00 00 00 00 00 10
10 80 80 00 00 00 00 00 00 00 00 80 00 00 00 00 00 00 00 10
10 10 10 00 00 80 00 00 00 00 00 10 00 00 00 00 00 00 00 10
10 00 00 00 00 10 40 40 40 40 40 10 00 00 00 00 00 00 00 10
10 80 00 00 00 10 10 10 10 10 10 10 00 00 00 00 00 00 00 10
10 10 80 00 00 00 00 00 00 00 00 00 00 00 00 00 00 00 00 10
10 10 10 80 00 00 00 00 00 00 00 00 00 00 00 00 00 00 00 10
10 00 10 10 80 00 00 00 00 00 00 00 00 00 00 00 00 00 00 10
10 00 00 10 10 80 00 00 00 00 00 00 00 00 00 00 00 00 00 10
10 00 00 00 10 10 80 80 00 00 00 00 00 00 00 00 00 00 00 10
10 00 00 00 00 10 10 10 40 40 40 10 40 40 40 40 40 10 00 10
10 00 00 00 00 00 10 10 10 10 10 10 10 10 10 10 10 10 00 10
10 00 00 00 00 00 00 00 00 00 00 00 00 00 00 00 00 00 00 10
10 00 00 00 00 00 00 00 00 00 00 00 00 00 00 00 00 00 00 10
10 00 00 00 00 00 00 00 00 00 00 00 00 00 00 00 00 00 00 10
10 00 00 00 00 00 00 00 00 00 00 00 00 00 00 00 00 00 00 10
10 00 00 00 00 00 00 00 00 00 00 00 00 00 00 00 00 00 00 10
10 00 00 00 00 00 00 00 00 00 00 00 00 00 00 00 00 00 00 10
10 00 00 00 00 00 00 00 00 00 00 00 00 00 00 00 00 00 00 10
10 00 00 00 00 00 00 00 00 00 00 00 00 00 00 00 00 00 00 10
10 00 00 00 00 00 00 00 00 00 00 00 00 00 00 00 00 00 00 10
10 00 00 00 00 00 00 00 00 00 00 00 00 00 00 00 00 00 00 10
10 00 00 00 00 00 00 00 00 00 00 00 00 00 00 00 00 00 00 10
10 00 00 00 00 00 00 00 00 00 00 00 00 00 00 00 00 00 00 10
10 10 10 10 10 10 10 10 10 10 10 10 10 10 10 10 10 10 10 10
