30 30
1 28
10 10 10 10 10 10 10 10 10 10 10 10 10 10 10 10 10 10 10 10 10 10 10 10 10 10 10 10 10 10
10 00 00 00 00 00 00 00 00 00 00 00 00 00 00 00 00 00 00 00 00 00 00 00 00 00 00 00 00 10
10 00 00 00 00 00 00 00 00 00 00 00 00 00 00 00 00 00 00 00 00 00 00 00 00 00 00 00 00 10
10 00 00 00 00 00 00 00 00 00 00 00 00 00 00 00 00 00 00 00 00 00 00 00 00 00 00 00 00 10
10 00 00 00 00 00 00 00 00 00 00 00 00 00 00 00 00 00 00 00 00 00 00 00 00 00 00 00 00 10
10 00 00 00 00 00 00 00 00 00 00 00 00 00 00 00 00 00 00 00 00 00 00 00 00 00 00 00 00 10
10 00 00 00 00 00 00 00 00 00 00 00 00 00 00 00 00 00 00 00 00 00 00 00 00 00 00 00 00 10
10 00 00 00 00 00 00 00 00 00 00 00 00 00 00 00 00 00 00 00 00 00 00 00 00 00 00 00 00 10
10 00 00 00 00 00 00 00 00 00 00 00 00 00 00 00 00 00 00 00 00 00 00 00 00 00 00 00 00 10
10 00 00 00 00 00 00 00 00 00 00 00 00 00 00 00 00 00 00 00 00 00 00 00 00 00 00 00 00 10
10 00 00 00 00 00 00 00 00 00 00 00 00 00 00 00 00 00 00 00 00 00 00 00 00 00 00 00 00 10
10 10 10 10 10 10 10 10 10 10 10 10 10 10 10 10 10 10 10 10 10 10 10 10 10 10 10 10 10 10
10 00 00 00 00 00 00 00 00 00 00 00 00 00 00 00 00 00 00 00 00 00 00 00 00 00 00 00 00 10
10 00 00 00 00 00 00 00 00 00 00 00 00 00 00 00 00 00 00 00 00 00 00 00 00 00 00 00 00 10
10 00 00 00 00 00 00 00 00 00 00 00 00 00 00 00 00 00 00 00 00 00 00 00 00 00 00 00 00 10
10 00 00 00 00 00 00 00 00 00 00 00 00 00 00 00 00 00 00 00 00 00 00 10 00 00 00 00 00 10
10 00 00 00 00 00 00 00 00 00 00 00 00 00 00 10 00 00 00 00 00 00 00 81 00 00 00 00 00 10
10 00 00 00 00 00 00 00 00 00 00 00 00 00 00 81 00 00 00 00 00 00 00 80 00 00 00 00 10 10
10 00 01 00 00 00 00 00 00 00 00 00 10 00 00 00 00 00 00 00 00 00 00 10 10 00 00 00 81 10
10 00 00 00 00 00 00 00 00 00 00 00 00 00 00 00 00 00 00 00 00 00 00 80 00 00 00 00 00 10
10 00 00 00 00 00 00 00 10 00 00 00 00 00 00 10 00 00 00 00 10 40 40 10 00 10 00 00 10 10
10 00 00 10 00 00 00 00 00 00 00 00 00 00 00 00 10 00 00 00 10 10 10 10 00 81 00 00 00 10
10 80 80 10 10 80 80 80 00 00 00 00 00 00 00 00 00 00 10 00 00 00 80 00 00 80 10 00 80 10
10 10 10 10 10 10 10 10 10 10 10 10 10 10 10 10 10 10 10 10 10 10 10 10 10 10 00 00 10 10
10 81 81 00 00 00 81 00 00 00 00 00 00 10 10 00 00 00 00 00 00 00 00 00 00 00 00 10 10 10
10 00 00 00 10 00 00 00 00 00 00 00 00 81 00 00 10 00 00 00 00 00 80 00 00 00 00 00 00 10
10 00 00 00 00 00 00 80 10 00 00 00 00 00 10 00 10 00 00 00 00 00 10 00 00 10 80 00 00 10
10 00 10 00 00 00 00 10 00 00 00 00 10 00 00 00 10 00 00 00 00 00 00 00 00 00 10 00 00 10
10 00 00 80 10 40 40 10 40 40 40 40 10 80 10 80 10 40 40 40 40 40 10 40 40 40 10 00 00 10
10 10 10 10 10 10 10 10 10 10 10 10 10 10 10 10 10 10 10 10 10 10 10 10 10 10 10 10 10 10
