20 20
1 18
10 10 10 10 10 10 10 10 10 10 10 10 10 10 10 10 10 10 10 10
10 01 00 00 00 00 00 00 00 00 00 00 00 00 00 00 00 00 00 10
10 00 00 00 00 00 00 00 00 00 00 00 00 00 00 00 00 00 00 10
10 10 00 00 00 00 00 00 00 80 00 10 40 40 40 10 00 00 00 10
10 40 40 40 10 80 00 80 10 10 00 10 10 10 10 10 00 00 00 10
10 08 08 08 10 10 00 10 10 00 00 00 00 00 00 80 00 00 10 10
10 10 10 10 10 00 00 00 00 00 00 10 00 00 00 10 10 00 00 10
10 00 00 00 00 00 80 80 10 00 00 10 00 00 00 00 00 00 00 10
10 00 00 00 10 10 10 10 10 00 00 10 80 00 00 00 10 10 40 10
10 00 00 10 10 00 00 00 00 00 00 10 10 00 00 00 00 00 10 10
10 00 00 00 00 00 00 00 10 00 00 81 81 10 80 80 80 80 00 10
10 10 00 00 00 00 00 00 10 00 00 00 00 00 10 10 10 10 00 10
10 40 40 40 10 40 40 40 10 80 80 10 00 00 00 00 81 81 00 10
10 08 08 08 10 08 08 08 10 10 10 10 80 80 80 00 00 00 00 10
10 10 10 10 10 10 10 10 10 10 10 10 10 10 10 10 10 10 00 10
10 81 81 00 00 81 81 81 00 00 00 00 00 00 00 00 00 00 00 10
10 00 00 00 10 00 00 00 00 00 10 00 00 00 00 00 00 10 00 10
10 00 00 00 10 00 10 00 00 00 00 00 10 00 80 00 00 00 00 10
10 00 90 10 10 80 80 80 80 10 40 40 40 40 10 00 00 80 80 10
10 10 10 10 10 10 10 10 10 10 10 10 10 10 10 10 10 10 10 10