20 20
1 1
10 10 10 10 10 10 10 10 10 10 10 10 10 10 10 10 10 10 10 10
10 00 00 00 00 00 00 00 00 00 00 00 00 00 00 00 00 00 00 10
10 00 00 00 00 00 00 00 00 00 00 00 00 00 00 00 00 00 00 10
10 10 10 10 10 10 10 10 10 10 10 10 10 10 10 10 10 00 00 10
10 00 00 00 00 00 00 00 00 00 00 00 00 00 00 00 00 00 00 10
10 00 00 10 10 10 10 10 10 10 10 10 10 10 10 10 10 10 10 10
10 00 00 00 00 00 00 00 00 00 00 00 00 00 00 00 00 00 00 10
10 00 00 00 00 10 00 00 00 00 00 10 00 00 00 00 00 00 00 10
10 10 10 10 10 10 10 10 10 10 10 10 10 10 10 10 10 00 00 10
10 00 00 00 00 00 00 00 00 00 00 00 00 00 00 00 00 00 00 10
10 00 00 00 00 00 00 00 00 00 80 00 00 00 00 00 00 00 00 10
10 00 00 10 10 10 10 10 10 10 10 10 10 10 10 10 10 10 10 10
10 00 00 00 00 00 00 00 00 00 00 00 00 00 00 00 00 00 00 10
10 00 00 00 00 00 00 00 00 00 00 00 00 00 30 00 00 00 00 10
10 10 10 10 40 40 40 10 10 10 10 10 00 00 00 00 00 10 00 10
10 00 00 10 10 10 10 10 00 00 00 10 80 80 80 80 80 10 00 10
10 00 00 00 00 00 00 00 00 00 00 10 10 10 10 10 10 10 00 10
10 00 00 00 00 00 00 00 00 00 00 10 10 10 10 10 10 00 00 10
10 00 01 00 00 00 07 07 00 00 00 81 81 81 81 81 81 00 00 10
10 10 10 10 10 10 10 10 10 10 10 10 10 10 10 10 10 10 10 10
